04 04 04 04 04 04 04 04 00 04 04 04 04 04 04 04 
04 04 07 06 08 04 05 07 04 06 06 08 07 05 07 04 
04 05 07 04 05 08 04 08 06 08 07 05 08 07 06 04 
04 04 04 04 08 07 06 07 06 08 07 05 08 07 04 04 
04 04 06 05 07 08 06 08 04 08 08 04 04 04 07 04 
04 07 04 05 07 06 06 06 06 04 07 05 07 07 06 04 
01 04 08 04 04 07 07 06 07 07 06 08 07 08 05 02 
04 07 06 07 04 05 07 08 07 05 04 08 07 04 04 04 
04 07 06 05 07 04 05 04 07 07 08 08 07 07 08 04 
04 06 05 08 04 07 05 05 04 04 05 08 05 08 04 04 
04 08 06 04 07 06 05 07 06 05 05 07 08 08 04 04 
04 04 04 04 04 04 04 04 03 04 04 04 04 04 04 04 
