00 00 00 00 00 00 00 00 01 00 00 00 00 00 00 00 
00 04 04 05 00 02 07 08 03 02 08 01 05 03 06 00 
00 06 04 06 02 00 00 00 07 03 07 00 08 06 03 00 
00 01 06 01 08 06 02 08 07 00 07 06 07 05 03 00 
00 01 02 06 01 03 01 01 00 00 01 03 04 02 07 00 
00 00 04 04 08 03 07 07 03 05 08 08 01 01 01 00 
01 02 05 03 05 01 00 05 02 08 04 02 08 06 00 01 
00 04 08 00 03 01 08 01 01 01 02 08 07 03 05 00 
00 05 01 00 01 05 00 03 02 06 02 06 00 01 00 00 
00 04 00 01 03 05 00 07 01 08 07 07 00 05 02 00 
00 03 05 01 04 04 05 04 00 07 08 02 00 05 02 00 
00 00 00 00 00 00 00 00 01 00 00 00 00 00 00 00 
