00 00 00 00 00 00 00 00 01 00 00 00 00 00 00 00 
00 03 07 00 07 07 02 01 05 00 08 04 05 00 00 00 
00 08 02 06 00 04 07 04 07 07 06 05 06 04 06 00 
00 03 03 06 01 08 06 00 04 03 07 07 05 05 04 00 
00 05 08 01 02 05 01 04 03 07 00 01 01 01 03 00 
00 00 05 07 06 05 05 02 06 06 08 01 02 04 02 00 
01 02 06 07 02 02 08 03 00 00 04 03 03 05 04 01 
00 04 08 00 05 00 08 03 06 06 01 05 02 08 08 00 
00 04 05 07 01 06 06 08 00 02 00 00 02 08 07 00 
00 03 00 05 07 03 04 00 06 08 05 08 01 04 04 00 
00 02 08 08 00 03 08 01 02 00 08 04 08 07 07 00 
00 00 00 00 00 00 00 00 01 00 00 00 00 00 00 00 
