00 00 00 00 00 00 00 00 01 00 00 00 00 00 00 00 
00 05 00 00 06 00 07 07 01 08 07 07 07 06 06 00 
00 04 08 02 03 08 08 05 00 01 00 05 07 05 07 00 
00 07 08 04 06 01 00 02 03 07 04 01 01 04 04 00 
00 03 07 04 02 03 04 08 04 08 01 08 03 06 01 00 
00 05 07 08 05 02 01 00 01 03 08 05 02 02 00 00 
01 07 01 03 01 04 04 03 08 01 01 00 02 04 08 01 
00 02 05 03 06 00 08 00 08 02 03 01 06 01 05 00 
00 08 05 04 05 03 02 05 07 08 04 08 03 03 08 00 
00 00 08 07 08 08 01 03 05 07 05 08 04 02 08 00 
00 06 02 08 04 05 04 08 06 04 07 07 02 02 06 00 
00 00 00 00 00 00 00 00 01 00 00 00 00 00 00 00 
