00 00 00 00 00 00 00 00 01 00 00 00 00 00 00 00 
00 04 02 06 06 05 08 07 02 02 03 05 07 02 07 00 
00 06 08 00 02 06 08 04 05 03 08 02 03 01 00 00 
00 02 05 04 02 05 04 06 00 06 06 03 04 01 00 00 
00 08 01 03 02 06 08 01 08 02 07 06 01 05 00 00 
00 00 02 07 01 08 02 08 00 08 02 04 02 01 00 00 
01 05 01 03 02 04 05 00 01 06 06 04 03 01 08 01 
00 05 00 03 03 06 05 02 08 05 08 01 04 06 06 00 
00 07 07 08 05 01 02 02 08 06 01 04 00 02 06 00 
00 08 03 06 02 01 08 02 02 07 00 03 03 02 03 00 
00 08 03 04 02 02 00 01 08 08 02 08 08 06 04 00 
00 00 00 00 00 00 00 00 01 00 00 00 00 00 00 00 
