00 00 00 00 00 00 00 00 01 00 00 00 00 00 00 00 
00 06 06 01 03 08 08 07 05 00 03 02 02 06 00 00 
00 01 02 07 04 03 02 02 06 02 07 03 07 01 05 00 
00 05 02 06 08 02 07 05 06 04 05 00 02 03 04 00 
00 07 06 03 05 08 05 06 02 04 04 00 01 04 03 00 
00 07 08 08 02 03 04 06 01 05 00 05 03 04 00 00 
01 01 06 02 05 08 07 03 08 06 02 00 01 05 07 01 
00 02 02 02 07 00 01 05 05 02 08 06 01 02 01 00 
00 03 06 07 07 03 00 03 01 03 08 02 02 05 00 00 
00 01 04 00 04 06 07 06 03 08 00 01 01 05 03 00 
00 02 01 03 05 00 02 01 07 05 07 03 03 01 00 00 
00 00 00 00 00 00 00 00 01 00 00 00 00 00 00 00 
