00 00 00 00 00 00 00 00 01 00 00 00 00 00 00 00 
00 05 08 07 04 08 01 03 00 07 02 08 02 07 06 00 
00 07 05 07 08 03 00 00 06 05 00 04 07 06 05 00 
00 08 05 02 00 02 00 06 04 08 01 07 03 02 06 00 
00 02 03 06 02 03 07 02 01 05 05 01 06 03 07 00 
00 02 03 07 04 04 02 05 06 00 01 04 05 04 04 00 
01 05 00 05 06 07 05 03 06 03 02 00 05 00 01 01 
00 00 05 07 05 08 01 06 03 02 01 02 01 08 03 00 
00 06 08 00 02 04 03 06 03 00 02 02 03 08 08 00 
00 05 01 06 06 02 03 03 06 01 06 08 06 08 08 00 
00 03 04 08 01 08 07 03 07 07 01 03 05 07 06 00 
00 00 00 00 00 00 00 00 01 00 00 00 00 00 00 00 
