00 00 00 00 00 00 00 00 01 00 00 00 00 00 00 00 
00 07 00 00 08 00 08 05 07 05 02 05 07 08 08 00 
00 03 05 05 01 01 08 01 02 05 05 04 04 05 05 00 
00 04 06 02 01 08 04 05 04 01 02 07 03 01 05 00 
00 01 06 05 04 01 06 01 00 01 05 04 02 00 05 00 
00 01 06 00 06 07 04 00 04 03 02 06 04 04 05 00 
01 07 08 08 04 06 08 02 04 07 08 04 07 01 07 01 
00 08 04 04 00 03 05 03 01 00 02 02 01 08 07 00 
00 05 05 03 01 04 01 04 02 02 03 03 04 08 07 00 
00 07 02 06 05 08 01 01 08 06 00 06 06 01 06 00 
00 07 03 01 01 06 01 04 04 00 05 06 06 03 01 00 
00 00 00 00 00 00 00 00 01 00 00 00 00 00 00 00 
