00 00 00 00 00 00 00 00 01 00 00 00 00 00 00 00 
00 06 04 01 07 04 03 00 04 05 06 06 08 08 01 00 
00 00 05 01 04 03 06 05 00 05 06 04 08 03 07 00 
00 03 05 07 00 06 01 02 06 03 04 01 08 08 05 00 
00 08 02 05 03 05 07 05 08 02 05 03 00 07 02 00 
00 04 06 07 00 00 01 08 04 04 00 03 03 05 08 00 
01 08 05 02 03 01 06 03 00 00 01 08 03 00 01 01 
00 04 02 05 02 08 03 02 08 07 06 02 00 01 06 00 
00 01 04 00 02 08 06 02 00 07 06 01 07 06 02 00 
00 01 07 03 06 08 02 04 01 06 05 04 01 08 02 00 
00 00 05 02 03 05 02 06 07 05 08 01 03 04 00 00 
00 00 00 00 00 00 00 00 01 00 00 00 00 00 00 00 
