04 04 04 04 04 04 04 04 00 04 04 04 04 04 04 04 
04 05 04 06 06 06 06 05 08 06 05 07 06 05 05 04 
04 07 07 07 06 07 05 04 05 06 05 04 04 08 05 04 
04 06 08 07 08 06 07 07 05 05 07 07 06 05 05 04 
04 06 06 07 06 07 04 07 04 07 06 07 07 05 04 04 
04 07 05 04 08 06 08 08 05 04 06 07 07 08 06 04 
01 06 04 05 06 06 06 04 06 08 05 04 07 06 07 02 
04 08 04 08 06 06 04 06 07 05 06 04 07 05 07 04 
04 07 04 07 05 06 04 06 07 08 05 07 07 06 04 04 
04 07 05 06 04 08 07 07 05 07 05 06 07 08 04 04 
04 04 04 05 05 07 04 04 07 07 06 07 04 05 04 04 
04 04 04 04 04 04 04 04 03 04 04 04 04 04 04 04 
