00 00 00 00 00 00 00 00 01 00 00 00 00 00 00 00 
00 07 04 07 06 05 07 03 08 07 00 03 01 05 04 00 
00 07 05 00 06 05 03 00 04 03 01 07 03 01 07 00 
00 03 03 05 06 04 08 03 00 04 02 05 00 04 00 00 
00 05 01 01 07 04 02 06 01 02 08 05 00 05 04 00 
00 06 08 07 06 04 00 04 00 02 06 02 02 06 01 00 
01 08 00 00 02 04 06 03 07 08 08 06 05 02 00 01 
00 05 07 02 02 06 06 07 07 08 04 03 06 07 06 00 
00 04 03 03 02 06 06 03 03 06 06 08 02 02 01 00 
00 02 01 04 06 01 07 04 07 07 05 01 05 06 05 00 
00 01 06 04 06 04 00 08 04 04 06 01 02 01 00 00 
00 00 00 00 00 00 00 00 01 00 00 00 00 00 00 00 
