00 00 00 00 00 00 00 00 01 00 00 00 00 00 00 00 
00 01 07 02 04 05 02 03 02 05 05 02 00 01 08 00 
00 04 08 06 05 05 01 01 03 00 08 03 03 01 06 00 
00 03 04 02 02 00 00 02 05 05 06 07 00 01 05 00 
00 08 07 05 03 04 01 01 00 03 03 04 06 04 07 00 
00 04 04 00 00 07 04 05 06 02 07 01 06 00 05 00 
01 02 01 08 03 06 08 06 02 06 02 00 00 03 08 01 
00 04 02 06 08 07 00 03 05 06 02 02 06 04 02 00 
00 05 06 00 06 00 05 04 00 00 01 07 05 05 07 00 
00 03 00 00 05 05 04 04 07 05 03 07 00 04 04 00 
00 06 00 02 04 06 07 00 08 07 02 01 06 03 05 00 
00 00 00 00 00 00 00 00 01 00 00 00 00 00 00 00 
