00 00 00 00 00 00 00 00 01 00 00 00 00 00 00 00 
00 00 07 02 00 02 03 07 06 00 08 01 07 00 08 00 
00 04 06 05 05 00 00 04 05 03 00 06 00 00 05 00 
00 02 02 00 01 04 00 00 04 06 03 01 05 01 03 00 
00 08 05 02 04 08 07 03 04 03 02 08 04 05 04 00 
00 03 03 01 03 03 06 05 00 07 04 06 03 04 03 00 
01 07 07 07 04 04 08 03 04 00 00 00 06 03 06 01 
00 01 03 05 04 07 03 06 04 07 00 03 04 04 08 00 
00 06 02 06 04 01 05 07 04 05 06 06 01 04 05 00 
00 04 06 00 00 00 03 08 07 06 04 08 03 00 08 00 
00 06 00 00 05 00 06 05 01 02 02 08 04 05 04 00 
00 00 00 00 00 00 00 00 01 00 00 00 00 00 00 00 
